########
#   #  #
# # ## #
# #    #
#    # #
########